111111111
1P0010001
100010001
100E00001
111101111
100000001
100010001
1C0010001
111111111