111111111111111111111111111
111000000000000000000000111
110000000000000000000000011
100001000000010000000100001
100010000000101000000010001
100100000000101000000001001
100000000000101000000000001
100000000000010000000000001
100000000000000000000000001
100000000000000000000000001
100000000000101000000000001
100000000001000100000000001
100000000010000010000000001
100P0000000000000000000B001
100000000010000010000000001
100000000001000100000000001
100000000000101000000000001
100000000000000000000000001
100000000000000000000000001
100000000000010000000000001
100000000000101000000000001
100100000000101000000001001
100010000000101000000010001
10000100000001000000010E001
110000000000000000000000011
111000000000000000000000111
111111111111111111111111111