111111111111111111111111111111111111111111
100000000C00111111110000111111111111111111
100P00011100000111000110001111111111111111
100000001111110000011110001111111111111111
1101111011111110D0111110111111111111111111
110111100000011000111110110011111111111111
11000111000D000011111110000011111111111111
110C00110111101111111111110111111111111111
110010000111100000000000000111111111111111
1110001100C0111000000000000111111111111111
110011110000111001110011100111111111111111
110111110110100001110011100111111111111111
110000110000001001110011100111111111111111
1110D0000111111000000000000111111111111111
111000111111111000000000000111111111111111
111000111111111001110011100111111111111111
111111111111111001110011100111111111111111
111111111111111001110011100111111111111111
111111111111111000000000000111111111111111
111111111111111000000000000111111111111111
111111111111111111111111111111111111111111
111111111111111111111111111111111110000001
11111111111111111111111111111111111000E001
111111111111111111111111111111111110000001
111111111111111111111111111111111111111111