111111111111111111111111111111111111111111
100000000C0011111111000011110D011110000001
100P00011100000111000110001100011110CCCC01
100000001111110000011110C01110111100000001
1101111011111110D0111110111100000000111011
110111100000011000001110110D01111011111011
11000111000D00001110111000001111D011100011
110C0011011110111110111111011100001110D011
110010000111100000000000C00111011000000011
1110001100C011100D000000000100011110111011
11001111000011100111C011100001111100110011
11011111011010000111001110010111000111C001
11000011000C001001110011100100C00100000101
1110D00001101110000000D0000110011111011101
111000111110111000000000000111000011011001
1000001111101110D1110011100111100D00010011
101110011110111001110011100001101101100111
100001000110111001110011100100000000C01111
111101110000000000C000000001110D0011000111
11000111110111100000000D000111000011100011
1101111111C1111110111111110111011111110001
1000000110011110000111111000D0011110000001
10CCCC00001110000D01111110000111111000E001
100000011000001000000000000000000000000001
111111111111111111111111111111111111111111