1111111111111111111111111111111111111111111111111111111
1110000000000000000000011111111100000000000000000000111
1100000000000000000000001111111000000000000000000000011
1000000000000000000000000011100000000000000000000000001
100000000000000000000000000000000000000D000000000000001
1000000000000000000000000000000000000000000000000000001
10000010001000000D0000000000000000000000000010001000001
1000010101010000000000000000000000000000000101010100001
10000000100000000000000000000000D0000000000000100000001
1000000010000010001000000000000000001000100000100000001
100D00001000010101010000000E000000010101010000100000001
1000000010000000100000000001000000000010000000100000001
1000000010000000100000000011100000000010000000100000001
1000000010000000100000000001000000000010000000100000001
10000000100000D0100000011100011100000010000000100000001
1000000010000000100000001111111000000010000D00100000001
1000000010000000100000000000000000000010000000100000001
1000000000000000100000000011100000000010000000000000001
1000000000000000100000000011100000000010000000000000001
100000D000000000100000000111110000000010000000000000001
1000000000000000000000000000000000000000000000000000001
1000000000000000000000000000000000000000000000000000001
100000000000000000000000000P000000000000000000000000001
1100000000000000000000000000000000000000000000000000011
111000000000000000000000000000000000000000D000000000111
1111000000000000000000000000000000000000000000000001111
1111111111111111111111111111111111111111111111111111111