1111111111111111111111111111111111
1E0000000000000C00000C000000000001
1010010100100000101001000000010101
1010010010101010001001000000010101
1P0000000C00C0000000000000000000C1
1111111111111111111111111111111111
1111111111111111111111111111111111
1101000101000111111111111111111111
1110111101000111111111111111111111
1100011101000111111111111111111111
1110111111111111111111111111111111
1111111111100011100011111111111111
1111111111001001001001111111111111
1111111111001100011001111111111111
1111111111100111110011111111111111
1111111111110011100111111111111111
1111111111111001001111111111111111
1111111111111100011111111111111111
1111111111111110111111111111111111
1111111111111111111111111111111111
1111111111111111111111111111111111
1111111111111101111101111111111111
1111111111111110111011111111111111
1111111111111100000001111111111111
1111111111111001000100111111111111
1111111111110000000000011111111111
1111111111110100000001011111111111
1111111111110101111101011111111111
1111111111111110010011111111111111
1111111111111111111111111111111111
