1111111111111111111111111111111111
1E0000000000000C00000C000000000001
1010010100100000101001000DD0010101
1010010010101010001001000DD0010101
1P0000000C00C0000000000000000000C1
1111111111111111111111111111111111
1101000101000111111111111111111111
1110111101000111111111111111111111
1100011101000111111111111111111111
1110111111111111111111111111111111
1111111111100011100011111111111111
1111111111001001001001111111111111
1111111111001100011001111111111111
1111111111100111110011111111111111
1111111111110011100111111111111111
1111111111111001001111111111111111
1111111111111100011111111111111111
1111111111111110111111111111111111
1111110111110111111000000000000111
1111111011101111111000000000000111
1111110000000111111000000000000111
1111100100010011111000000000000111
1111000000000001111000000000000111
1111010000000101111000000000000111
1111010111110101111000000000000111
1111111001001111111000000000000111
1111111111111111111111111111111111