11111111111111111
10000000000000001
10000000000000001
100P00000000B0001
10000000000000001
10000000000000001
100000000000000E1
11111111111111111