11111111111111111111111111111111111111111111111
10000000000000000000000000000000000000000000001
10000P00000000000000000000000000000000000000001
10000000000000000000000000000000000000000000001
1000000000000000000000000000000B000000000000001
10000000000000000000000000000000000000000000001
100000000000000000000B0000000000000000000000001
10000000000000000000000000000000000000000000001
10000000000000000000000000000000000000000000001
10000000000000000000000000000000000000000000001
10000000000000000000000000000000000000000000001
100000000000000B0000000000000000000000B00000001
10000000000000000000000000000000000000000000001
10000000000000000000000000000000000000000000001
1000000000000000B000000000000000000000000000001
100000000000000000000000B0000000000000000000001
10000000000000000000000000000000000000000000001
100000000000000000000000000000000000000000000E1
11111111111111111111111111111111111111111111111