111111111111111111111111111111111111111111111
100000000000000000000000000000000000000000001
100000C000000000000000000C0000000000000000001
100000000000000000000000000000000000000000001
100000000000000000000000000000000000000000001
1000000000C0000000000000000000000000000000001
100000000000000000000000100000000000000000001
100000000010000000000001110000000000000000001
100000000010000000110011111000000000000000011
110000001111000011111111111000000000000000111
1110001111111001111111111111000000000C0000111
111111111111111111111111111110000000000000111
111111111111111111111011111110000000000000111
111111111111111111111111111110000000000000111
111111011111111111111111111110000000000000111
111111111111111111111111111000000000000000111
111111111111111111111111111110000000000000111
111111111111111111111111111110000000000000111
111111111111111111111111111110000000000000111
111111111111111111111111111110000000000000111
111111111111111011111111111110000000000000111
111111111111111111111111111110000000000000111
111111111111111111111111111110000000000000111
100000000000000000000000000000000000000000001
10P000000000000000000000000000000000000000E01
100000000000000000000000000000000000000000001
111111111111111111111111111111111111111111111